9 TO 5 - PARTON, DOLLY|9 TO 5 - PARTON, DOLLY|9 TO 5|PARTON, DOLLY|
ALONE - HEART|ALONE - HEART|ALONE|HEART|
BAT OUT OF HELL - MEATLOAF|BAT OUT OF HELL - MEATLOAF|BAT OUT OF HELL|MEATLOAF|
BREEZEBLOCKS - ALT J|BREEZEBLOCKS - ALT J|BREEZEBLOCKS|ALT J|
D'YER MAK'R - LED ZEPPELIN|D'YER MAK'R - LED ZEPPELIN|D'YER MAK'R|LED ZEPPELIN|
DANCE THE NIGHT AWAY - VAN HALEN|DANCE THE NIGHT AWAY - VAN HALEN|DANCE THE NIGHT AWAY|VAN HALEN|
DREAM ON - AEROSMITH|DREAM ON - AEROSMITH|DREAM ON|AEROSMITH|
DREAMS - FLEETWOOD MAC|DREAMS - FLEETWOOD MAC|DREAMS|FLEETWOOD MAC|
FRIENDS IN LOW PLACES - BROOKS, GARTH|FRIENDS IN LOW PLACES - BROOKS, GARTH|FRIENDS IN LOW PLACES|BROOKS, GARTH|
GIVE ME ONE REASON - CHAPMAN, TRACY|GIVE ME ONE REASON - CHAPMAN, TRACY|GIVE ME ONE REASON|CHAPMAN, TRACY|
GO YOUR OWN WAY - FLEETWOOD MAC|GO YOUR OWN WAY - FLEETWOOD MAC|GO YOUR OWN WAY|FLEETWOOD MAC|
I REMEMBER YOU - SKID ROW|I REMEMBER YOU - SKID ROW|I REMEMBER YOU|SKID ROW|
I'D RATHER GO BLIND - JAMES, ETTA|I'D RATHER GO BLIND - JAMES, ETTA|I'D RATHER GO BLIND|JAMES, ETTA|
JOLENE - PARTON, DOLLY|JOLENE - PARTON, DOLLY|JOLENE|PARTON, DOLLY|
KISS - PRINCE|KISS - PRINCE|KISS|PRINCE|
LONG TIME - BOSTON|LONG TIME - BOSTON|LONG TIME|BOSTON|
LOVE SONG - TESLA|LOVE SONG - TESLA|LOVE SONG|TESLA|
MAGIC MAN - HEART|MAGIC MAN - HEART|MAGIC MAN|HEART|
MAYBE IT WAS MEMPHIS - TILLIS, PAM|MAYBE IT WAS MEMPHIS - TILLIS, PAM|MAYBE IT WAS MEMPHIS|TILLIS, PAM|
ME AND BOBBY MCGEE - JOPLIN, JANIS|ME AND BOBBY MCGEE - JOPLIN, JANIS|ME AND BOBBY MCGEE|JOPLIN, JANIS|
MODERN DAY COWBOY - TESLA|MODERN DAY COWBOY - TESLA|MODERN DAY COWBOY|TESLA|
NO ONE ELSE ON EARTH - JUDD, WYNONNA|NO ONE ELSE ON EARTH - JUDD, WYNONNA|NO ONE ELSE ON EARTH|JUDD, WYNONNA|
PANAMA - VAN HALEN|PANAMA - VAN HALEN|PANAMA|VAN HALEN|
PINK - AEROSMITH|PINK - AEROSMITH|PINK|AEROSMITH|
PYROMANIA - DEF LEPPARD|PYROMANIA - DEF LEPPARD|PYROMANIA|DEF LEPPARD|
RHIANNON - FLEETWOOD MAC|RHIANNON - FLEETWOOD MAC|RHIANNON|FLEETWOOD MAC|
ROCK OF AGES - DEF LEPPARD|ROCK OF AGES - DEF LEPPARD|ROCK OF AGES|DEF LEPPARD|
TARO - ALT J|TARO - ALT J|TARO|ALT J|
THE BONES - MORRIS, MAREN|THE BONES - MORRIS, MAREN|THE BONES|MORRIS, MAREN|
UNKNOWN - UNKNOWN|UNKNOWN - UNKNOWN|UNKNOWN|UNKNOWN|
WHAT YOU GIVE - TESLA|WHAT YOU GIVE - TESLA|WHAT YOU GIVE|TESLA|
WHAT'S LOVE GOT TO DO WITH IT? - TURNER, TINA|WHAT'S LOVE GOT TO DO WITH IT? - TURNER, TINA|WHAT'S LOVE GOT TO DO WITH IT?|TURNER, TINA|
